USD: Amerikan Doları
EUR: Avro
GBP: İngiliz Sterlini
CHF: İsviçre Frangı
CAD: Kanada Doları
RUB: Rus Rublesi
AED: Birleşik Arap Emirlikleri Dirhemi
AUD: Avustralya Doları
DKK: Danimarka Kronu
SEK: İsveç Kronu
NOK: Norveç Kronu
JPY: Japon Yeni
KWD: Kuveyt Dinarı
ZAR: Güney Afrika Randı
BHD: Bahreyn Dinarı
LYD: Libya Dinarı
SAR: Suudi Riyali
IQD: Irak Dinarı
ILS: İsrail Yeni Şekeli
IRR: İran Riyali
INR: Hindistan Rupisi
MXN: Meksika Pezosu
HUF: Macar Forinti
NZD: Yeni Zelanda Doları
BRL: Brezilya Reali
IDR: Endonezya Rupisi
CZK: Çek Korunası
PLN: Polonya Zlotisi
RON: Rumen Leyi
CNY: Çin Yuanı
ARS: Arjantin Pezosu
ALL: Arnavut Leki
AZN: Azerbaycan Manatı
BAM: Bosna Hersek Konvertibıl Markı
CLP: Şili Pezosu
COP: Kolombiya Pezosu
CRC: Kosta Rika Kolonu
DZD: Cezayir Dinarı
EGP: Mısır Lirası
HKD: Hong Kong Doları
ISK: İzlanda Kronası
HRK: Hırvatistan Kunası
JOD: Ürdün Dinarı
KRW: Güney Kore Wonu
KZT: Kazakistan Tengesi
LBP: Lübnan Lirası
LKR: Sri Lanka Rupisi
MAD: Fas Dirhemi
MDL: Moldova Leyi
MKD: Makedonya Dinarı
MYR: Malezya Ringgiti
OMR: Umman Riyali
PEN: Peru Nuevo Solu
PHP: Filipinler Pezosu
PKR: Pakistan Rupisi
QAR: Katar Riyali
RSD: Sırp Dinarı
SGD: Singapur Doları
SYP: Suriye Lirası
THB: Tayland Bahtı
TWD: Yeni Tayvan Doları
UAH: Ukrayna Grivnası
UYU: Uruguay Pezosu
GEL: Gürcistan Larisi
TND: Tunus Dinarı
BGN: Bulgar Levası
ONS: Ons Altın
GRA: Gram Altın
CEY: Çeyrek Altın
YAR: Yarım Altın
TAM: Tam Altın
CUM: Cumhuriyet Altını
ATA: Ata Altın
ODA: 14 Ayar Altın
OSA: 18 Ayar Altın
YIA: 22 Ayar Bilezik
IKI: İkibuçuk Altın
BES: Beşli Altın
GRE: Gremse Altın
RES: Reşat Altın
HAM: Hamit Altın
GUM: Gümüş